ru	{'Частота': 8}
http	{'Частота': 6}
royallib	{'Частота': 6}
shpalikov	{'Частота': 4}
gennadiy	{'Частота': 4}
html	{'Частота': 4}
Royallib	{'Частота': 2}
author	{'Частота': 2}
stihi	{'Частота': 2}
шпаликов	{'Частота': 2}
To	{'Частота': 2}
book	{'Частота': 1}
негоциантка	{'Частота': 1}
подлипка	{'Частота': 1}
айболитка	{'Частота': 1}
расставаясти	{'Частота': 1}
руссо	{'Частота': 1}
терня	{'Частота': 1}
бяш	{'Частота': 1}
лепо	{'Частота': 1}
comment	{'Частота': 1}
