data	{'Частота': 2}
One	{'Частота': 2}
предобработка	{'Частота': 2}
регуляризация	{'Частота': 2}
многоклассовый	{'Частота': 2}
mining	{'Частота': 1}
big	{'Частота': 1}
hot	{'Частота': 1}
encoding	{'Частота': 1}
advantages	{'Частота': 1}
видос	{'Частота': 1}
MSE	{'Частота': 1}
RMSE	{'Частота': 1}
MAE	{'Частота': 1}
MSLE	{'Частота': 1}
MAPE	{'Частота': 1}
AdaGrad	{'Частота': 1}
RMSprop	{'Частота': 1}
Leave	{'Частота': 1}
Out	{'Частота': 1}
accuracy	{'Частота': 1}
precision	{'Частота': 1}
recall	{'Частота': 1}
score	{'Частота': 1}
макроусреднение	{'Частота': 1}
SoftMax	{'Частота': 1}
